2
0
0 0
14 14
- x 0 0 0 0 0 0 0 0 0 0 x - 
x - 0 0 0 0 0 0 0 0 0 0 - x 
0 0 - 0 0 0 0 0 0 0 0 - 0 0 
0 0 0 - 0 0 0 0 0 0 - 0 0 0 
0 0 0 0 c 0 0 0 0 c 0 0 0 0 
0 0 0 0 0 0 0 0 0 0 0 0 0 0 
0 0 0 0 0 0 2 1 0 0 0 0 0 0 
0 0 0 0 0 0 1 2 0 0 0 0 0 0 
0 0 0 0 0 0 0 0 0 0 0 0 0 0 
0 0 0 0 c 0 0 0 0 c 0 0 0 0 
0 0 0 - 0 0 0 0 0 0 - 0 0 0 
0 0 - 0 0 0 0 0 0 0 0 - 0 0 
x - 0 0 0 0 0 0 0 0 0 0 - x 
- x 0 0 0 0 0 0 0 0 0 0 x - 
