3
0
0 0
8 8
- - - - - - - - 
- 1 0 0 1 0 0 1 
- 0 2 0 2 0 2 0 
- 0 0 3 3 3 0 0 
- 1 2 3 i 3 2 1 
- 0 0 3 3 3 0 0 
- 0 2 0 2 0 2 0 
- 1 0 0 1 0 0 1 
