2
1
0 0
8 11
- - - - - - 1 - - - - 
- - - - - - 2 - - - - 
- 2 2 2 2 2 2 2 1 1 0 
- - - - - - 2 - - - - 
- - - - - - 2 - - - - 
- - - - - - 2 - - - - 
- - - - - - 2 - - - - 
- - - - - - 2 - - - - 
1 2 6 <-> 6 7 4
