3
3
0 2
15 15
0 0 0 0 0 0 0 0 0 0 0 0 0 0 0 
0 0 0 0 0 0 0 0 0 0 0 0 0 0 0 
0 0 x x 0 0 0 0 0 0 0 x x 0 0 
0 0 x c x 0 0 0 0 0 x c x 0 0 
0 0 x x x x 0 0 0 x x x x 0 0 
0 0 0 0 0 0 1 2 1 0 0 0 0 0 0 
0 0 0 0 0 0 2 3 2 0 0 0 0 0 0 
0 0 0 0 0 0 3 1 3 0 0 0 0 0 0 
0 0 - - - - - - - - - - - 0 0 
0 0 - 0 0 i 0 0 0 i 0 0 - 0 0 
0 0 - 0 0 0 0 b 0 0 0 0 - 0 0 
0 0 - 0 0 0 0 0 0 0 0 0 - 0 0 
0 0 - - - - - - - - - - - 0 0 
0 0 0 0 0 0 0 0 0 0 0 0 0 0 0 
0 0 0 0 0 0 0 0 0 0 0 0 0 0 0 
1 10 2 <-> 3 10 6
13 10 2 <-> 11 10 6
