2
3
20 0
15 15
0 0 0 0 0 0 0 0 0 0 0 0 0 0 0 
0 0 0 0 0 0 0 0 0 0 0 0 0 0 0 
0 0 x x 0 0 0 0 0 0 0 x x 0 0 
0 0 x c x 0 0 0 0 0 x c x 0 0 
0 0 x x x x 0 0 0 x x x x 0 0 
0 0 0 0 0 0 1 2 1 0 0 0 0 0 0 
0 0 0 0 0 0 2 2 2 0 0 0 0 0 0 
0 0 0 0 0 0 1 1 1 0 0 0 0 0 0 
0 0 - - - - - - - - - - - 0 0 
0 0 - 0 0 i 0 0 0 i 0 0 - 0 0 
0 0 - 0 0 0 0 b 0 0 0 0 - 0 0 
0 0 - 0 0 0 0 0 0 0 0 0 - 0 0 
0 0 - - - - - - - - - - - 0 0 
0 0 0 0 0 0 0 0 0 0 0 0 0 0 0 
0 0 0 0 0 0 0 0 0 0 0 0 0 0 0 
11 10 2 <-> 13 10 6
13 10 5 <-> 11 10 1
13 10 7 <-> 11 10 3
1 10 1 <-> 3 10 5
1 10 3 <-> 3 10 7
