5
20
4 3
50 50
0 0 0 0 0 0 0 0 0 0 0 0 0 0 0 0 0 - - - - - - - - - - - - - - - - 0 0 0 0 0 0 0 0 0 0 0 0 0 0 0 0 0
0 0 0 0 0 0 0 0 0 0 0 0 0 0 0 0 0 - - - - - - - - - - - - - - - - 0 0 0 0 0 0 0 0 0 0 0 0 0 0 0 0 0
0 0 0 0 0 0 0 0 0 0 0 0 0 0 0 0 0 - - - - - - - - - - - - - - - - 0 0 0 0 0 0 0 0 0 0 0 0 0 0 0 0 0
0 0 0 0 0 0 0 0 c 0 0 0 0 0 0 0 0 - - - - - - - - - - - - - - - - 0 0 0 0 0 0 0 0 i 0 0 0 0 0 0 0 0
0 0 0 0 0 0 0 0 c 0 0 0 0 0 0 0 0 - - - - - - - - - - - - - - - - 0 0 0 0 0 0 0 0 i 0 0 0 0 0 0 0 0
0 0 0 0 0 0 0 0 c 0 0 0 0 0 0 0 0 - - - - - 0 0 0 0 0 0 - - - - - 0 0 0 0 0 0 0 0 i 0 0 0 0 0 0 0 0
0 0 0 0 0 0 0 0 c 0 0 0 0 0 0 0 0 - - - - - 0 0 0 0 0 0 - - - - - 0 0 0 0 0 0 0 0 i 0 0 0 0 0 0 0 0
0 0 0 0 0 0 0 0 c 0 0 0 0 0 0 0 0 - - - - - 0 0 0 0 0 0 - - - - - 0 0 0 0 0 0 0 0 i 0 0 0 0 0 0 0 0
0 0 0 0 0 0 0 0 c 0 0 0 0 0 0 0 0 - - - - - 0 0 0 0 0 0 - - - - - 0 0 0 0 0 0 0 0 i 0 0 0 0 0 0 0 0
0 0 0 0 0 0 0 0 c 0 0 0 0 0 0 0 0 - - - - - 0 0 0 0 0 0 - - - - - 0 0 0 0 0 0 0 0 i 0 0 0 0 0 0 0 0
0 0 0 0 0 0 0 0 c 0 0 0 0 0 0 0 0 - - - - - 0 0 0 0 0 0 - - - - - 0 0 0 0 0 0 0 0 i 0 0 0 0 0 0 0 0
0 0 0 0 0 0 0 0 c 0 0 0 0 0 0 0 0 - - - - - 0 0 0 0 0 0 - - - - - 0 0 0 0 0 0 0 0 i 0 0 0 0 0 0 0 0
0 0 0 0 0 0 0 0 c 0 0 0 0 0 0 0 0 - - - - - - - - - - - - - - - - 0 0 0 0 0 0 0 0 i 0 0 0 0 0 0 0 0
0 0 0 0 0 0 0 0 0 0 0 0 0 0 0 0 0 - - - - - - - - - - - - - - - - 0 0 0 0 0 0 0 0 0 0 0 0 0 0 0 0 0
0 0 0 0 0 0 0 0 0 0 0 0 0 0 0 0 0 - - - - - - - - - - - - - - - - 0 0 0 0 0 0 0 0 0 0 0 0 0 0 0 0 0
0 0 0 0 0 0 0 0 0 0 0 0 0 0 0 0 0 - - - - - - - - - - - - - - - - 0 0 0 0 0 0 0 0 0 0 0 0 0 0 0 0 0
0 0 0 0 0 0 0 0 0 0 0 0 0 0 0 0 - - - - - - - - - - - - - - - - - - 0 0 0 0 0 0 0 0 0 0 0 0 0 0 0 0
- - - - - - - - - - - - - - - - - 0 0 0 0 0 0 0 0 0 0 0 0 0 0 0 0 - - - - - - - - - - - - - - - - -
- - - - - - - - - - - - - - - - - 0 0 0 0 0 0 0 0 0 0 0 0 0 0 0 0 - - - - - - - - - - - - - - - - -
- - - - - - - - - - - - - - - - - 0 0 0 0 0 0 0 0 0 0 0 0 0 0 0 0 - - - - - - - - - - - - - - - - -
- - - - - - - - - - - - - - - - - 0 0 0 0 0 0 0 0 0 0 0 0 0 0 0 0 - - - - - - - - - - - - - - - - -
- - - - - - - - - - - - - - - - - 0 0 0 0 0 0 0 0 0 0 0 0 0 0 0 0 - - - - - - - - - - - - - - - - -
- - - - - 0 0 0 0 0 0 0 - - - - - 0 0 0 0 0 0 5 1 2 0 0 0 0 0 0 0 - - - - - 0 0 0 0 0 0 0 - - - - -
- - - - - 0 0 0 0 0 0 0 - - - - - 0 0 0 0 0 0 0 3 4 0 0 0 0 0 0 0 - - - - - 0 0 0 0 0 0 0 - - - - -
- - - - - 0 0 0 0 0 0 0 - - - - - 0 0 0 0 0 0 0 0 0 0 0 0 0 0 0 0 - - - - - 0 0 0 0 0 0 0 - - - - -
- - - - - 0 0 0 0 0 0 0 - - - - - 0 0 0 0 0 0 0 2 3 0 0 0 0 0 0 0 - - - - - 0 0 0 0 0 0 0 - - - - -
- - - - - 0 0 0 0 0 0 0 - - - - - 0 0 0 0 0 0 0 4 1 5 0 0 0 0 0 0 - - - - - 0 0 0 0 0 0 0 - - - - -
- - - - - 0 0 0 0 0 0 0 - - - - - 0 0 0 0 0 0 0 0 0 0 0 0 0 0 0 0 - - - - - 0 0 0 0 0 0 0 - - - - -
- - - - - - - - - - - - - - - - - 0 0 0 0 0 0 0 0 0 0 0 0 0 0 0 0 - - - - - - - - - - - - - - - - -
- - - - - - - - - - - - - - - - - 0 0 0 0 0 0 0 0 0 0 0 0 0 0 0 0 - - - - - - - - - - - - - - - - -
- - - - - - - - - - - - - - - - - 0 0 0 0 0 0 0 0 0 0 0 0 0 0 0 0 - - - - - - - - - - - - - - - - -
- - - - - - - - - - - - - - - - - 0 0 0 0 0 0 0 0 0 0 0 0 0 0 0 0 - - - - - - - - - - - - - - - - -
- - - - - - - - - - - - - - - - - 0 0 0 0 0 0 0 0 0 0 0 0 0 0 0 0 - - - - - - - - - - - - - - - - -
0 0 0 0 0 0 0 0 0 0 0 0 0 0 0 0 - - - - - - - - - - - - - - - - - - 0 0 0 0 0 0 0 0 0 0 0 0 0 0 0 0
0 0 0 0 0 0 0 0 0 0 0 0 0 0 0 0 0 - - - - - - - - - - - - - - - - 0 0 0 0 0 0 0 0 0 0 0 0 0 0 0 0 0
0 0 0 0 0 0 0 0 0 0 0 0 0 0 0 0 0 - - - - - - - - - - - - - - - - 0 0 0 0 0 0 0 0 0 0 0 0 0 0 0 0 0
0 0 0 0 0 0 0 0 0 0 0 0 0 0 0 0 0 - - - - - - - - - - - - - - - - 0 0 0 0 0 0 0 0 0 0 0 0 0 0 0 0 0
0 0 0 0 0 0 0 0 b 0 0 0 0 0 0 0 0 - - - - - - - - - - - - - - - - 0 0 0 0 0 0 0 0 x 0 0 0 0 0 0 0 0
0 0 0 0 0 0 0 0 b 0 0 0 0 0 0 0 0 - - - - - 0 0 0 0 0 0 - - - - - 0 0 0 0 0 0 0 0 x 0 0 0 0 0 0 0 0
0 0 0 0 0 0 0 0 b 0 0 0 0 0 0 0 0 - - - - - 0 0 0 0 0 0 - - - - - 0 0 0 0 0 0 0 0 x 0 0 0 0 0 0 0 0
0 0 0 0 0 0 0 0 b 0 0 0 0 0 0 0 0 - - - - - 0 0 0 0 0 0 - - - - - 0 0 0 0 0 0 0 0 x 0 0 0 0 0 0 0 0
0 0 0 0 0 0 0 0 b 0 0 0 0 0 0 0 0 - - - - - 0 0 0 0 0 0 - - - - - 0 0 0 0 0 0 0 0 x 0 0 0 0 0 0 0 0
0 0 0 0 0 0 0 0 b 0 0 0 0 0 0 0 0 - - - - - 0 0 0 0 0 0 - - - - - 0 0 0 0 0 0 0 0 x 0 0 0 0 0 0 0 0
0 0 0 0 0 0 0 0 b 0 0 0 0 0 0 0 0 - - - - - 0 0 0 0 0 0 - - - - - 0 0 0 0 0 0 0 0 x 0 0 0 0 0 0 0 0
0 0 0 0 0 0 0 0 b 0 0 0 0 0 0 0 0 - - - - - 0 0 0 0 0 0 - - - - - 0 0 0 0 0 0 0 0 x 0 0 0 0 0 0 0 0
0 0 0 0 0 0 0 0 b 0 0 0 0 0 0 0 0 - - - - - - - - - - - - - - - - 0 0 0 0 0 0 0 0 x 0 0 0 0 0 0 0 0
0 0 0 0 0 0 0 0 b 0 0 0 0 0 0 0 0 - - - - - - - - - - - - - - - - 0 0 0 0 0 0 0 0 x 0 0 0 0 0 0 0 0
0 0 0 0 0 0 0 0 0 0 0 0 0 0 0 0 0 - - - - - - - - - - - - - - - - 0 0 0 0 0 0 0 0 0 0 0 0 0 0 0 0 0
0 0 0 0 0 0 0 0 0 0 0 0 0 0 0 0 0 - - - - - - - - - - - - - - - - 0 0 0 0 0 0 0 0 0 0 0 0 0 0 0 0 0
0 0 0 0 0 0 0 0 0 0 0 0 0 0 0 0 0 - - - - - - - - - - - - - - - - 0 0 0 0 0 0 0 0 0 0 0 0 0 0 0 0 0
17 17 7 <-> 15 15 3
32 17 1 <-> 34 15 5
32 32 3 <-> 34 34 7
17 32 5 <-> 16 33 2
17 24 6 <-> 11 24 2
25 17 0 <-> 25 11 4
32 25 2 <-> 38 25 6
24 32 4 <-> 24 38 0
