7
1
0 0
12 12
7 7 1 6 0 0 0 0 6 1 7 7 
7 1 1 6 0 0 0 0 i 1 1 7 
1 1 6 6 0 0 0 0 6 6 1 1 
6 6 6 0 0 0 c 1 2 6 x 6 
1 2 3 4 5 6 7 1 6 0 0 0 
0 1 0 0 0 0 0 0 b 0 0 0 
0 b 0 0 0 0 2 0 0 0 0 0 
0 2 2 2 0 0 0 2 2 2 0 0 
0 0 0 0 2 2 2 0 0 2 2 2 
2 2 2 2 2 2 2 2 2 2 2 2 
2 2 2 2 2 2 2 2 2 2 2 2 
7 1 6 0 0 2 2 2 0 6 1 7  
