2
0
1 1
12 12
1 1 1 2 1 1 2 2 2 1 1 1 
1 1 1 1 1 1 2 2 2 1 1 1 
1 1 1 1 1 1 1 1 1 1 1 1 
1 1 1 1 1 1 1 1 1 1 1 1 
1 1 1 1 1 1 1 1 1 1 1 1 
1 1 1 1 1 1 1 1 1 1 1 1 
2 2 2 2 2 2 2 2 2 2 2 2 
2 2 2 2 2 2 2 2 2 2 2 2 
2 2 2 2 2 2 2 2 2 2 2 2 
2 2 2 2 2 2 2 2 2 2 2 2 
2 2 1 1 1 2 2 2 2 2 2 2 
2 2 1 1 1 2 2 1 2 2 2 2  
7 0 0 <-> 7 11 4
3 0 0 <-> 3 11 4
