2
3
10 1
17 17
0 0 0 0 0 0 0 0 - - - - - 0 0 0 0
0 c i 0 0 0 0 0 - - - - - 0 c i 0
0 b x 0 c i 0 0 - - - - - 0 b x 0
0 0 0 0 b x 0 0 - - - - - 0 0 0 0
0 c i 0 0 0 0 0 - - - - - - - - -
0 b x 0 0 0 0 0 - - - - - - - - -
0 0 0 0 c i 0 0 - - - - - - - - -
0 0 0 0 b x 0 0 - - - - - - - - -
0 0 0 0 0 0 0 - - - - - - - - - -
- - - - - - - - 0 0 0 0 0 0 0 0 0
- - - - - - - - 0 0 c i 0 0 c i 0
- - - - - - - - 0 0 b x 0 0 b x 0
- - - - - - - - 0 0 0 0 1 2 0 0 0
- - - - - - - - 0 0 0 0 2 1 0 0 0
0 c i - - - - - 0 0 c i 0 0 c i 0
0 b x - - - - - 0 0 b x 0 0 b x 0
0 0 0 - - - - - 0 0 0 0 0 0 0 0 0
8 9 5 <-> 6 7 3
8 9 7 <-> 2 14 1
8 9 1 <-> 13 3 5
