2
2
2 2
8 8
b 0 0 b b 0 0 b
x x x x x x x x
0 0 i 0 0 b 0 0
0 0 0 1 2 0 0 0
0 0 0 2 1 0 0 0
0 0 i 0 0 b 0 0
x x x x x x x x
b 0 0 b b 0 0 b