2
0
10 2
20 20
0 0 0 0 0 0 0 0 0 0 0 0 0 0 0 0 0 0 0 0
- 0 0 0 0 0 0 0 0 0 0 0 0 0 0 0 0 0 0 -
- - 0 0 0 0 0 0 0 0 0 0 0 0 0 0 0 0 - -
- - 0 0 0 0 0 0 0 0 0 0 0 0 0 0 0 0 - -
- - - 0 0 0 0 0 0 0 0 0 0 0 0 0 0 - - -
- - - 0 0 0 0 0 0 0 0 0 0 0 0 0 0 - - -
- - - 0 0 0 0 0 0 0 0 0 0 0 0 0 0 - - -
- - - - 0 0 0 0 0 0 0 0 0 0 0 0 - - - -
- - - - 0 0 0 0 0 0 0 0 0 0 0 0 - - - -
- - - - - 0 0 0 0 1 2 0 0 0 0 - - - - -
- - - - - 0 0 2 2 2 1 0 0 0 0 - - - - -
- - - - 0 0 0 0 0 0 0 0 0 0 0 0 - - - -
- - - - 0 0 0 0 0 0 0 0 0 0 0 0 - - - -
- - - 0 0 0 0 0 0 0 0 0 0 0 0 0 0 - - -
- - - 0 0 0 0 0 0 0 0 0 0 0 0 0 0 - - -
- - - 0 0 0 0 0 0 0 0 0 0 0 0 0 0 - - -
- - 0 0 0 0 0 0 0 0 0 0 0 0 0 0 0 0 - -
- - 0 0 0 0 0 0 0 0 0 0 0 0 0 0 0 0 - -
- 0 0 0 0 0 0 0 0 0 0 0 0 0 0 0 0 0 0 -
0 0 0 0 0 0 0 0 0 0 0 0 0 0 0 0 0 0 0 0