8
255
2 2
50 50
- - - - - - - - - - - - - - - - - - - - - - - - - - - - - - - - - - - - - - - - - - - - - - - - - -
- - - - - - - - - - - - - - - - - - - - - - - - - - - - - - - - - - - - - - - - - - - - - - - - - -
- - - - - - - - - - - - - - - - - - - - - - - - - - - - - - - - - - - - - - - - - - - - - - - - - -
- - - - - - - - - - - - - 0 0 0 0 x 0 0 0 0 - - - - - - - - - - - - - - - - - - - - - - - - - - - -
- - - - - - - - - - - - 0 0 0 0 0 0 0 0 0 - - - - - - - - - - - - 0 b 0 - - - - - - - - - - - - - -
- - - - - - - - 0 0 0 0 x 0 - - 0 0 b 0 0 - - - - - - - - - - 0 0 0 0 0 0 0 0 0 0 - - - - - - - - -
- - 0 x 0 0 0 0 0 0 0 0 0 0 0 - 0 0 0 0 - - - - - 0 0 0 - 0 0 0 0 0 0 0 0 0 0 0 0 0 0 0 0 0 - - - -
- 0 0 0 0 0 0 x 0 0 0 0 0 0 0 - 0 0 0 - 0 - - - 0 0 0 0 0 0 0 0 0 0 x 0 0 0 0 0 0 0 0 0 0 0 8 - - -
6 0 0 0 0 0 0 0 0 0 0 - 0 0 - - 0 - - - - - - 0 0 0 0 0 0 0 0 0 0 0 0 0 0 0 0 0 0 0 0 0 0 0 6 - - -
8 0 - - 0 0 0 0 0 0 - - 0 0 - - - - - - - - - 0 0 0 0 0 5 6 0 0 0 0 0 0 0 0 7 8 0 0 0 0 0 0 - - - -
- - - - 0 0 0 0 0 0 0 x 0 0 0 - - - - - - 0 0 0 0 0 0 0 6 5 0 0 0 0 0 0 0 0 8 7 0 0 0 - 0 0 - - - -
- - - - 0 0 0 7 5 0 0 0 0 0 0 - - - - - - 0 0 c 0 0 0 0 0 0 0 0 0 0 0 0 0 0 0 0 0 0 0 0 - 0 - - - -
- - - - 0 0 0 5 7 0 0 0 0 - 0 - - - - - - - 0 0 0 0 0 0 0 0 0 0 0 i 0 0 0 0 0 0 0 0 0 0 - - - - - -
- - - 0 0 0 0 0 0 0 0 0 0 - - - - - - - - - 0 0 0 0 0 b 0 0 0 0 0 0 0 0 0 0 0 0 0 0 0 0 c - - - - -
- - - 0 0 0 0 0 0 0 0 0 - - - - - - - - - 0 0 0 0 0 0 0 0 0 0 0 0 0 0 0 0 0 0 0 0 0 0 - 0 - - - - -
- - - 0 0 0 0 0 0 x 0 - - - - - - - - - - 0 0 - 0 0 0 0 0 0 0 0 0 0 0 0 0 0 0 0 0 0 0 - 0 - - - - -
- - - 0 0 x 0 0 0 0 - - - - - - - - - - - b 0 0 0 - - - 0 0 0 3 4 0 0 0 0 0 x 0 0 0 0 0 0 - - - - -
- - - 0 0 0 0 0 0 0 - - - - - - - - - - - 0 0 0 0 0 0 0 0 0 0 4 3 0 0 0 0 0 0 0 0 0 - 0 - - - - - -
- - - 0 0 0 0 - 0 0 - - - - - - - - - - 0 0 0 0 0 0 0 0 0 0 0 0 0 0 0 0 0 0 0 0 0 0 0 - - - - - - -
- - - 0 0 0 0 - - - - - - - - - - - - - 0 0 x 0 0 0 0 0 0 0 0 0 0 0 0 0 0 0 0 0 0 0 0 - - - - - - -
- - - - 0 0 - - 0 0 - - - - - - - - - 0 0 0 0 0 0 0 1 2 0 0 0 0 0 - 0 0 0 0 0 0 0 0 - - - - - - - -
- - - - - 0 0 0 - 0 b - - - - - - - - 0 0 0 0 0 0 0 2 1 0 0 0 0 - - 0 0 0 - 0 0 0 0 - - - - - - - -
- - - - - - 0 0 0 - - - - - - - - - - 0 0 0 0 0 0 0 0 0 0 0 0 0 - - - 0 - - 0 0 0 - 0 - - - - - - -
- - - - - - - 0 0 - 0 - - - - - - - - 0 0 0 0 0 0 0 0 0 0 0 0 - - - - 0 - - - 0 0 - - 0 - - - - - -
- - - - - - - - i 0 0 0 - - - - - - - - 0 b 0 0 0 0 0 0 0 0 0 - - - - b - - - 0 0 - - x - - - - - -
- - - - - - - - - 0 0 0 0 0 - - - - - - 0 0 0 0 0 0 0 x 0 0 0 - - - - - - - - 0 - - 0 b - - - - - -
- - - - - - - - - 0 x 0 0 b - - - - - - - - - - 0 0 0 0 0 0 - - - - - - - - - 0 - 0 0 - - - - - - -
- - - - - - - - 0 0 0 0 0 0 0 - - - - - - - - - 0 0 0 0 0 0 - - - - - - - - - 0 0 0 c 0 0 - - - - -
- - - - - - - - 0 x 0 0 0 0 0 0 - - - - - - - - 0 0 0 0 0 - - - - - - - - - - 0 x 0 0 0 0 0 0 - 0 -
- - - - - - - - 0 0 0 0 0 0 0 0 0 - - - - - - - 0 0 0 0 0 - - - - - - - - - - - 0 0 - - - 0 0 x - -
- - - - - - - - - 0 0 2 4 0 0 0 0 - - - - - - - 0 x 0 0 0 - - - - - - - - - - - - - 0 0 - - 0 0 - -
- - - - - - - - - 0 0 4 2 0 x 0 - - - - - - - - 0 0 0 0 0 0 0 - - - - - - - - - - - - 0 x 0 - - - -
- - - - - - - - - - 0 0 0 0 0 0 - - - - - - - - 0 0 0 0 0 - 0 - - - - - - - - - - - 0 0 0 0 - - - -
- - - - - - - - - - 0 0 0 0 0 0 - - - - - - - - 0 0 i 0 0 0 0 - - - - - - - - - - 0 0 0 0 0 - - - -
- - - - - - - - - - x 0 0 0 0 0 - - - - - - - - 0 0 0 0 0 0 0 - - - - - - - - - 0 0 0 1 3 0 0 - - -
- - - - - - - - - - 0 0 0 0 0 - - - - - - - - - - 0 0 0 - - - - - - - - - - - - 0 0 0 3 1 0 0 - - -
- - - - - - - - - - 0 0 x 0 0 - - - - - - - - - - 0 0 0 - - - - - - - - - - - - 0 x 0 0 0 0 0 - - -
- - - - - - - - - - 0 0 0 0 - - - - - - - - - - - 0 0 0 - - - - - - - - - - - - 0 0 0 0 0 0 x - - -
- - - - - - - - - - 0 0 0 0 - - - - - - - - - - - - 0 - - - - - - - - - - - - - 0 - - 0 0 0 - - - -
- - - - - - - - - - - 0 0 0 - - - - - - - - - - - - - - - - - - - - - - - - - - - - - - 0 - - - - 0
- - - - - - - - - - - 0 0 - - - - - - - - - - - - - - - - - - - - - - - - - - - - - - - - - - - 0 -
- - - - - - - - - - - 0 0 - - - - - - - - - - - - - - - - - - - - - - - - - - - - - - - - - - 0 - -
- - - - - - - - - - - 0 0 - - - - - - - - - - - - - - - - - - - - - - - - - - - - - - - - - - - - -
- - - - - - - - - - - - 0 - - - - - - - - - - - - - - - - - - - - - - - - - - - - - - - - - - - - -
- - - - - - - - - - - - 0 - - - - - - - - - - - - - - - - - - - - - - - - - - - - - - - - - - - - -
- - - - - - - - - - - - - - - - - - - - - - - - - - - - - - - - - - - - - - - - - - - - - - - - - -
- - - - - - - - - - - - - - - - - - - - - - - - - - - - - - - - - - - - - - - - - - - - - - - - - -
- - - - - - - - - - - - - - - - - - - - - - - - - - - - - - - - - - - - - - - - - - - - - - - - - -
- - - - - - - - - - - - - - - - - - - - - - - - - - - - - - - - - - - - - - - - - - - - - - - - - -
- - - - - - - - - - - - - - - - - - - - - - - - - - - - - - - - - - - - - - - - - - - - - - - - - -

0 8 6 <-> 46 7 2
0 9 6 <-> 46 8 2
0 8 5 <-> 46 8 1
0 9 7 <-> 46 7 3
44 39 3 <-> 47 41 7
45 38 3 <-> 48 40 7
46 37 3 <-> 49 39 7
12 44 4 <-> 26 38 4
5 20 2 <-> 8 20 6
19 20 6 <-> 9 20 2
7 21 2 <-> 9 21 6
19 21 6 <-> 10 21 2
29 27 2 <-> 39 27 6
28 28 2 <-> 39 28 6
28 29 2 <-> 40 29 6
48 28 2 <-> 8 28 6
47 29 2 <-> 8 29 6
47 30 2 <-> 9 30 6
