2
8
0 6
15 15
- - - - - - - - - - - - - - -
- - - - - x x x x x - - - - -
- - - x 0 0 0 0 0 0 x x - - -
- - x 0 0 0 0 0 0 0 0 0 x - -
- - x 0 0 0 0 i 0 0 0 0 x - -
- x 0 0 0 0 0 0 0 0 0 0 0 x -
- x 0 0 0 0 1 1 1 0 0 0 0 x -
- x 0 i 0 0 1 b 2 0 0 i 0 x -
- x 0 0 0 0 2 2 2 0 0 0 0 x -
- x 0 0 0 0 0 0 0 0 0 0 0 x -
- - x 0 0 0 0 i 0 0 0 0 x - -
- - x 0 0 0 0 0 0 0 0 0 x - -
- - - x x 0 0 0 0 0 x x - - -
- - - - - x x x x x - - - - -
- - - - - - - - - - - - - - -
