2
0
0 0
10 10
1 0 0 0 0 0 0 0 0 2
0 0 0 0 0 0 0 0 0 0
0 0 0 0 0 0 0 0 0 0
0 0 0 0 0 0 0 0 0 0
0 0 0 0 0 0 0 0 0 0
0 0 0 0 0 0 0 0 0 0
0 0 0 0 0 0 0 0 0 0
0 0 0 0 0 0 0 0 0 0
0 0 0 0 0 0 0 0 0 0
2 0 0 0 0 0 0 0 0 1
0 0 7 <-> 9 9 3
0 0 0 <-> 0 9 4
0 0 1 <-> 1 9 5
0 0 6 <-> 9 0 2
0 0 5 <-> 9 1 1
0 1 7 <-> 9 0 3
0 1 6 <-> 9 1 2
0 1 5 <-> 9 2 1
0 2 7 <-> 9 1 3
0 2 6 <-> 9 2 2
0 2 5 <-> 9 3 1
0 3 7 <-> 9 2 3
0 3 6 <-> 9 3 2
0 3 5 <-> 9 4 1
0 4 7 <-> 9 3 3
0 4 6 <-> 9 4 2
0 4 5 <-> 9 5 1
0 5 7 <-> 9 4 3
0 5 6 <-> 9 5 2
0 5 5 <-> 9 6 1
0 6 7 <-> 9 5 3
0 6 6 <-> 9 6 2
0 6 5 <-> 9 7 1
0 7 7 <-> 9 6 3
0 7 6 <-> 9 7 2
0 7 5 <-> 9 8 1
0 8 7 <-> 9 7 3
0 8 6 <-> 9 8 2
0 8 5 <-> 9 9 1
0 9 7 <-> 9 8 3
0 9 6 <-> 9 9 2
9 0 1 <-> 0 9 5
1 0 7 <-> 0 9 3
1 0 0 <-> 1 9 4
1 0 1 <-> 2 9 5
2 0 7 <-> 1 9 3
2 0 0 <-> 2 9 4
2 0 1 <-> 3 9 5
3 0 7 <-> 2 9 3
3 0 0 <-> 3 9 4
3 0 1 <-> 4 9 5
4 0 7 <-> 3 9 3
4 0 0 <-> 4 9 4
4 0 1 <-> 5 9 5
5 0 7 <-> 4 9 3
5 0 0 <-> 5 9 4
5 0 1 <-> 6 9 5
6 0 7 <-> 5 9 3
6 0 0 <-> 6 9 4
6 0 1 <-> 7 9 5
7 0 7 <-> 6 9 3
7 0 0 <-> 7 9 4
7 0 1 <-> 8 9 5
8 0 7 <-> 7 9 3
8 0 0 <-> 8 9 4
8 0 1 <-> 9 9 5
9 0 7 <-> 8 9 3
9 0 0 <-> 9 9 4

