3
6
2 4
25 25
0 0 0 0 0 - - - - - - - - - - - - - - - 0 0 0 0 0
0 c x 0 0 0 - - - - - - - - - - - - - 0 0 0 x c 0
0 x x 0 0 0 0 - - - - - - - - - - - 0 0 0 0 x x 0
0 0 0 0 0 0 0 0 - - - - - - - - - 0 0 0 0 0 0 0 0
0 0 0 0 0 0 0 0 0 - - - - - - - 0 0 0 0 0 0 0 0 0
- 0 0 - - 0 - - 0 0 - - - - - 0 0 - - 0 - - 0 0 -
- - 0 0 - - 0 - - 0 0 - - - 0 0 - - 0 - - 0 0 - -
- - - 0 0 - - 0 - - 0 0 - 0 0 - - 0 - - 0 0 - - -
- - - - 0 0 - - 0 - - 0 0 0 - - 0 - - 0 0 - - - -
- - - - - 0 0 - - 0 - 0 i 0 - 0 - - 0 0 - - - - -
- - - - - - 0 0 - - 0 0 0 0 0 - - 0 0 - - - - - -
- - - - - - - 0 0 0 0 1 2 1 0 0 0 0 - - - - - - -
- - - - - - - - 0 i 0 2 3 3 0 i 0 - - - - - - - -
- - - - - - - 0 0 0 0 3 1 2 0 0 0 0 - - - - - - -
- - - - - - 0 0 - - 0 0 0 0 0 - - 0 0 - - - - - -
- - - - - 0 0 - - 0 - 0 i 0 - 0 - - 0 0 - - - - -
- - - - 0 0 - - 0 - - 0 0 0 - - 0 - - 0 0 - - - -
- - - 0 0 - - 0 - - 0 0 - 0 0 - - 0 - - 0 0 - - -
- - 0 0 - - 0 - - 0 0 - - - 0 0 - - 0 - - 0 0 - -
- 0 0 - - 0 - - 0 0 - - - - - 0 0 - - 0 - - 0 0 -
0 0 0 0 0 0 0 0 0 - - - - - - - 0 0 0 0 0 0 0 0 0
0 0 x 0 0 0 0 0 - - - - - - - - - 0 0 0 0 0 x 0 0
0 0 x x 0 0 0 - - - - - - - - - - - 0 0 0 x x 0 0
0 b 0 0 0 0 - - - - - - - - - - - - - 0 0 0 0 b 0
0 0 0 0 0 - - - - - - - - - - - - - - - 0 0 0 0 0
0 0 6 <-> 24 0 2
0 1 6 <-> 24 1 2
0 2 6 <-> 24 2 2
0 3 6 <-> 24 3 2
0 4 6 <-> 24 4 2
0 20 6 <-> 24 20 2
0 21 6 <-> 24 21 2
0 22 6 <-> 24 22 2
0 23 6 <-> 24 23 2
0 24 6 <-> 24 24 2
0 0 0 <-> 0 24 4
1 0 0 <-> 1 24 4
2 0 0 <-> 2 24 4
3 0 0 <-> 3 24 4
4 0 0 <-> 4 24 4
20 0 0 <-> 20 24 4
21 0 0 <-> 21 24 4
22 0 0 <-> 22 24 4
23 0 0 <-> 23 24 4
24 0 0 <-> 24 24 4
0 0 7 <-> 24 24 3
1 0 7 <-> 24 23 3
2 0 7 <-> 24 22 3
0 1 7 <-> 23 24 3
0 2 7 <-> 22 24 3
22 0 1 <-> 0 22 5
23 0 1 <-> 0 23 5
24 0 1 <-> 0 24 5
24 1 1 <-> 1 24 5
24 2 1 <-> 2 24 5
