2
0
0 0
10 10
- 0 0 0 0 0 0 0 0 - 
0 - 0 0 1 2 0 0 - 0
0 0 - 0 2 1 0 - 0 0
0 0 0 - 0 0 - 0 0 0
0 2 1 0 - - 0 2 1 0
0 1 2 0 - - 0 1 2 0
0 0 0 - 0 0 - 0 0 0
0 0 - 0 2 1 0 - 0 0
0 - 0 0 1 2 0 0 - 0
- 0 0 0 0 0 0 0 0 -
4 3 4 <-> 4 6 0
5 3 4 <-> 5 6 0
3 4 2 <-> 6 4 6
3 5 2 <-> 6 5 6
