2
1
0 1
20 20
b 0 0 0 b 0 0 b 0 - - - 0 x 0 0 b 0 b 0 
0 0 0 0 0 0 0 0 0 - - - 0 0 0 0 0 0 0 0 
- 0 0 0 b 0 0 b 0 - - - 0 0 0 0 0 0 b 0 
0 0 0 0 0 0 0 0 0 - - - 0 0 0 1 2 0 0 0 
- b 0 0 0 0 0 0 0 - - - 0 0 0 2 1 0 0 0 
0 0 0 0 0 0 0 0 b - - - 0 0 0 0 0 0 0 0 
- 0 0 0 x 0 0 0 0 - - - 0 0 0 0 0 0 b 0 
x 0 0 0 0 0 b 0 - - - - 0 0 0 0 0 0 0 0 
- - - - - - - - 0 0 0 0 0 x 0 0 0 0 0 0 
- - - - - - - - 0 b b 0 0 0 0 0 0 0 0 0 
- - - - - - - - 0 0 0 0 0 0 0 0 0 b 0 0 
- - - - - - - - 0 0 0 0 b 0 0 0 0 0 0 0 
b 0 0 0 0 b 0 0 0 0 0 0 0 0 0 0 0 0 0 0 
0 0 0 0 0 0 0 0 0 b 0 0 0 0 b 0 0 0 0 0 
0 0 0 0 0 0 0 0 0 x 0 0 0 0 0 0 0 0 0 0 
0 0 0 b 0 0 0 0 0 i 0 0 0 0 0 0 0 x 0 0 
0 0 0 0 0 0 0 0 0 0 0 0 0 0 0 0 0 0 0 0 
0 0 0 0 0 0 0 0 0 0 0 0 0 0 0 0 0 b 0 0 
0 0 0 0 0 0 0 0 0 0 0 0 0 x 0 0 0 0 0 b 
b 0 0 0 0 b 0 0 0 0 0 0 0 0 0 0 0 0 0 0 