1	5
2	6
3	4 2
4	26 26
5	0 0 0 0 0 0 0 0 0 0 0 0 0 b 0 0 0 0 0 0 0 0 0 0 0 0
6	c 0 0 0 0 0 0 0 0 0 0 0 0 0 0 0 0 0 0 0 0 0 0 0 0 i
7	0 0 0 0 0 0 0 0 0 0 0 0 0 0 0 0 0 0 0 0 0 0 0 0 0 0
8	- - - - - - - - - - - - - - - - - - - - - - - - - -
9	- - - - - - - - - - - - - - - - - - - - - - - - - -
10	- - - - - - - - - - - - - - - - - - - - - - - - - -
11	0 0 0 0 0 0 0 0 0 0 0 0 x 0 x 0 0 0 0 0 0 0 0 0 0 0
12	0 0 0 0 0 0 0 0 0 0 0 0 x x x 0 0 0 0 0 0 0 0 0 0 0
13	0 0 0 0 0 0 0 0 0 0 0 0 0 0 0 0 0 0 0 0 0 0 0 0 0 0
14	- - - - - - - - - - - - - - - - - - - - - - - - - -
15	- - - - - - - - - - - - - - - - - - - - - - - - - -
16	0 0 0 0 0 0 0 0 0 0 1 2 3 4 5 0 0 0 0 0 0 0 0 0 0 0
17	0 0 0 0 0 0 0 0 0 0 5 1 2 3 4 0 0 0 0 0 0 0 0 0 0 0
18	0 0 0 0 0 0 0 0 0 0 4 5 1 2 3 0 0 0 0 0 0 0 0 0 0 0
19	0 0 0 0 0 0 0 0 0 0 3 4 5 1 2 0 0 0 0 0 0 0 0 0 0 0
20	0 0 0 0 0 0 0 0 0 0 2 3 4 5 1 0 0 0 0 0 0 0 0 0 0 0
21	- - - - - - - - - - - - - - - - - - - - - - - - - -
22	- - - - - - - - - - - - - - - - - - - - - - - - - -
23	0 0 0 0 0 0 0 0 0 0 0 0 0 0 0 0 0 0 0 0 0 0 0 0 0 0
24	0 0 0 0 0 0 0 0 0 0 0 0 x x x 0 0 0 0 0 0 0 0 0 0 0
25	0 0 0 0 0 0 0 0 0 0 0 0 x 0 x 0 0 0 0 0 0 0 0 0 0 0
26	- - - - - - - - - - - - - - - - - - - - - - - - - -
27	- - - - - - - - - - - - - - - - - - - - - - - - - -
28	- - - - - - - - - - - - - - - - - - - - - - - - - -
29	0 0 0 0 0 0 0 0 0 0 0 0 0 0 0 0 0 0 0 0 0 0 0 0 0 0 
30	i 0 0 0 0 0 0 0 0 0 0 0 0 0 0 0 0 0 0 0 0 0 0 0 0 c
31	0 0 0 0 0 0 0 0 0 0 0 0 0 b 0 0 0 0 0 0 0 0 0 0 0 0
32	0 11 7 <-> 25 6 5
33	25 11 1 <-> 0 6 7
34	13 6 0 <-> 13 2	0
35 	0 15 5 <-> 25 18 5
36 	25 15 3 <-> 0 18 3
37	13 20 4 <-> 13 24 4