5
20
4 3
50 50
0 0 0 0 0 0 0 0 0 0 0 0 0 0 0 0 0 - - - - - - - - - - - - - - - - 0 0 0 0 0 0 0 0 0 0 0 0 0 0 0 0 0
0 0 0 0 0 0 0 0 0 0 0 0 0 0 0 0 0 - - - - - - - - - - - - - - - - 0 0 0 0 0 0 0 0 0 0 0 0 0 0 0 0 0
0 0 0 0 0 0 0 0 0 0 0 0 0 0 0 0 0 - - - - - - - - - - - - - - - - 0 0 0 0 0 0 0 0 0 0 0 0 0 0 0 0 0
0 0 0 0 0 0 0 0 c 0 0 0 0 0 0 0 0 - - - - - - - - - - - - - - - - 0 0 0 0 0 0 0 0 i 0 0 0 0 0 0 0 0
0 0 0 0 0 0 0 0 c 0 0 0 0 0 0 0 0 - - - - - - - - - - - - - - - - 0 0 0 0 0 0 0 0 i 0 0 0 0 0 0 0 0
0 0 0 0 0 0 0 0 c 0 0 0 0 0 0 0 0 - - - - - 0 0 0 0 0 0 - - - - - 0 0 0 0 0 0 0 0 i 0 0 0 0 0 0 0 0
0 0 0 0 0 0 0 0 c 0 0 0 0 0 0 0 0 - - - - - 0 0 0 0 0 0 - - - - - 0 0 0 0 0 0 0 0 i 0 0 0 0 0 0 0 0
0 0 0 0 0 0 0 0 c 0 0 0 0 0 0 0 0 - - - - - 0 0 0 0 0 0 - - - - - 0 0 0 0 0 0 0 0 i 0 0 0 0 0 0 0 0
0 0 0 0 0 0 0 0 c 0 0 0 0 0 0 0 0 - - - - - 0 0 0 0 0 0 - - - - - 0 0 0 0 0 0 0 0 i 0 0 0 0 0 0 0 0
0 0 0 0 0 0 0 0 c 0 0 0 0 0 0 0 0 - - - - - 0 0 0 0 0 0 - - - - - 0 0 0 0 0 0 0 0 i 0 0 0 0 0 0 0 0
0 0 0 0 0 0 0 0 c 0 0 0 0 0 0 0 0 - - - - - 0 0 0 0 0 0 - - - - - 0 0 0 0 0 0 0 0 i 0 0 0 0 0 0 0 0
0 0 0 0 0 0 0 0 c 0 0 0 0 0 0 0 0 - - - - - 0 0 0 0 0 0 - - - - - 0 0 0 0 0 0 0 0 i 0 0 0 0 0 0 0 0
0 0 0 0 0 0 0 0 c 0 0 0 0 0 0 0 0 - - - - - - - - - - - - - - - - 0 0 0 0 0 0 0 0 i 0 0 0 0 0 0 0 0
0 0 0 0 0 0 0 0 0 0 0 0 0 0 0 0 0 - - - - - - - - - - - - - - - - 0 0 0 0 0 0 0 0 0 0 0 0 0 0 0 0 0
0 0 0 0 0 0 0 0 0 0 0 0 0 0 0 0 0 - - - - - - - - - - - - - - - - 0 0 0 0 0 0 0 0 0 0 0 0 0 0 0 0 0
0 0 0 0 0 0 0 0 0 0 0 0 0 0 0 0 0 - - - - - - - - - - - - - - - - 0 0 0 0 0 0 0 0 0 0 0 0 0 0 0 0 0
0 0 0 0 0 0 0 0 0 0 0 0 0 0 0 0 - - - - - - - - - - - - - - - - - - 0 0 0 0 0 0 0 0 0 0 0 0 0 0 0 0
- - - - - - - - - - - - - - - - - 0 0 0 0 0 0 0 0 0 0 0 0 0 0 0 0 - - - - - - - - - - - - - - - - -
- - - - - - - - - - - - - - - - - 0 0 0 0 0 0 0 0 0 0 0 0 0 0 0 0 - - - - - - - - - - - - - - - - -
- - - - - - - - - - - - - - - - - 0 0 0 0 0 0 0 0 0 0 0 0 0 0 0 0 - - - - - - - - - - - - - - - - -
- - - - - - - - - - - - - - - - - 0 0 0 0 0 0 0 0 0 0 0 0 0 0 0 0 - - - - - - - - - - - - - - - - -
- - - - - - - - - - - - - - - - - 0 0 0 0 0 0 0 0 0 0 0 0 0 0 0 0 - - - - - - - - - - - - - - - - -
- - - - - 0 0 0 0 0 0 0 - - - - - 0 0 0 0 0 0 0 1 2 0 0 0 0 0 0 0 - - - - - 0 0 0 0 0 0 0 - - - - -
- - - - - 0 0 0 0 0 0 0 - - - - - 0 0 0 0 0 0 0 3 4 0 0 0 0 0 0 0 - - - - - 0 0 0 0 0 0 0 - - - - -
- - - - - 0 0 0 0 0 0 0 - - - - - 0 0 0 0 0 0 0 5 1 0 0 0 0 0 0 0 - - - - - 0 0 0 0 0 0 0 - - - - -
- - - - - 0 0 0 0 0 0 0 - - - - - 0 0 0 0 0 0 0 2 3 0 0 0 0 0 0 0 - - - - - 0 0 0 0 0 0 0 - - - - -
- - - - - 0 0 0 0 0 0 0 - - - - - 0 0 0 0 0 0 0 4 5 0 0 0 0 0 0 0 - - - - - 0 0 0 0 0 0 0 - - - - -
- - - - - 0 0 0 0 0 0 0 - - - - - 0 0 0 0 0 0 0 0 0 0 0 0 0 0 0 0 - - - - - 0 0 0 0 0 0 0 - - - - -
- - - - - - - - - - - - - - - - - 0 0 0 0 0 0 0 0 0 0 0 0 0 0 0 0 - - - - - - - - - - - - - - - - -
- - - - - - - - - - - - - - - - - 0 0 0 0 0 0 0 0 0 0 0 0 0 0 0 0 - - - - - - - - - - - - - - - - -
- - - - - - - - - - - - - - - - - 0 0 0 0 0 0 0 0 0 0 0 0 0 0 0 0 - - - - - - - - - - - - - - - - -
- - - - - - - - - - - - - - - - - 0 0 0 0 0 0 0 0 0 0 0 0 0 0 0 0 - - - - - - - - - - - - - - - - -
- - - - - - - - - - - - - - - - - 0 0 0 0 0 0 0 0 0 0 0 0 0 0 0 0 - - - - - - - - - - - - - - - - -
0 0 0 0 0 0 0 0 0 0 0 0 0 0 0 0 - - - - - - - - - - - - - - - - - - 0 0 0 0 0 0 0 0 0 0 0 0 0 0 0 0
0 0 0 0 0 0 0 0 0 0 0 0 0 0 0 0 0 - - - - - - - - - - - - - - - - 0 0 0 0 0 0 0 0 0 0 0 0 0 0 0 0 0
0 0 0 0 0 0 0 0 0 0 0 0 0 0 0 0 0 - - - - - - - - - - - - - - - - 0 0 0 0 0 0 0 0 0 0 0 0 0 0 0 0 0
0 0 0 0 0 0 0 0 0 0 0 0 0 0 0 0 0 - - - - - - - - - - - - - - - - 0 0 0 0 0 0 0 0 0 0 0 0 0 0 0 0 0
0 0 0 0 0 0 0 0 b 0 0 0 0 0 0 0 0 - - - - - - - - - - - - - - - - 0 0 0 0 0 0 0 0 x 0 0 0 0 0 0 0 0
0 0 0 0 0 0 0 0 b 0 0 0 0 0 0 0 0 - - - - - 0 0 0 0 0 0 - - - - - 0 0 0 0 0 0 0 0 x 0 0 0 0 0 0 0 0
0 0 0 0 0 0 0 0 b 0 0 0 0 0 0 0 0 - - - - - 0 0 0 0 0 0 - - - - - 0 0 0 0 0 0 0 0 x 0 0 0 0 0 0 0 0
0 0 0 0 0 0 0 0 b 0 0 0 0 0 0 0 0 - - - - - 0 0 0 0 0 0 - - - - - 0 0 0 0 0 0 0 0 x 0 0 0 0 0 0 0 0
0 0 0 0 0 0 0 0 b 0 0 0 0 0 0 0 0 - - - - - 0 0 0 0 0 0 - - - - - 0 0 0 0 0 0 0 0 x 0 0 0 0 0 0 0 0
0 0 0 0 0 0 0 0 b 0 0 0 0 0 0 0 0 - - - - - 0 0 0 0 0 0 - - - - - 0 0 0 0 0 0 0 0 x 0 0 0 0 0 0 0 0
0 0 0 0 0 0 0 0 b 0 0 0 0 0 0 0 0 - - - - - 0 0 0 0 0 0 - - - - - 0 0 0 0 0 0 0 0 x 0 0 0 0 0 0 0 0
0 0 0 0 0 0 0 0 b 0 0 0 0 0 0 0 0 - - - - - 0 0 0 0 0 0 - - - - - 0 0 0 0 0 0 0 0 x 0 0 0 0 0 0 0 0
0 0 0 0 0 0 0 0 b 0 0 0 0 0 0 0 0 - - - - - - - - - - - - - - - - 0 0 0 0 0 0 0 0 x 0 0 0 0 0 0 0 0
0 0 0 0 0 0 0 0 b 0 0 0 0 0 0 0 0 - - - - - - - - - - - - - - - - 0 0 0 0 0 0 0 0 x 0 0 0 0 0 0 0 0
0 0 0 0 0 0 0 0 0 0 0 0 0 0 0 0 0 - - - - - - - - - - - - - - - - 0 0 0 0 0 0 0 0 0 0 0 0 0 0 0 0 0
0 0 0 0 0 0 0 0 0 0 0 0 0 0 0 0 0 - - - - - - - - - - - - - - - - 0 0 0 0 0 0 0 0 0 0 0 0 0 0 0 0 0
0 0 0 0 0 0 0 0 0 0 0 0 0 0 0 0 0 - - - - - - - - - - - - - - - - 0 0 0 0 0 0 0 0 0 0 0 0 0 0 0 0 0
18 18 7 <-> 16 16 3
33 18 1 <-> 35 16 5
33 33 3 <-> 35 35 7
18 33 5 <-> 16 35 5
18 25 6 <-> 12 25 2
26 18 0 <-> 26 12 4
33 26 2 <-> 39 26 6
25 33 4 <-> 25 39 0
