1	3
2	5
3	0 0
4	15 15
5	0 0 0 0 0 - - - - - 0 0 0 0 0
6	0 i 0 0 0 - - - - - 0 0 0 i 0
7	0 0 0 0 0 0 - - - 0 0 0 0 0 0
8	0 0 0 0 0 0 0 0 0 0 0 0 0 0 0
9	- - - - 0 0 0 0 0 0 0 - - - -
10	- - - - - 0 0 0 0 0 - - - - -
11	- - - - - 0 2 3 1 0 - - - - -
12	- - - - - 0 3 1 2 0 - - - - -
13	- - - - - 0 1 2 3 0 - - - - -
14	- - - - - 0 0 0 0 0 - - - - -
15	- - - - 0 0 0 0 0 0 0 - - - -
16	0 0 0 0 0 0 0 0 0 0 0 0 0 0 0
17	0 0 0 0 0 0 - - - 0 0 0 0 0 0
18	0 i 0 0 0 - - - - - 0 0 0 i 0
19	0 0 0 0 0 - - - - - 0 0 0 0 0
20
21
22
