3
2
0 0
29 29
- - - - - - - - - 0 0 0 0 - - - - - - - - - - - - - - - - 
- - - - - - 0 0 i i i 0 0 0 0 - - - - - - - - - - - - - -
- - - - - 0 b b i i c c c c c 0 - - - - - - - - - - - - -
- - - - - 0 b b b 0 0 0 0 0 0 - b b - - - - - - - - - - -
- - - - - - 0 0 0 - - - b - b - - - b b - - - - - - - - -
- - - - - - - - - - - b - - b - - - - - b - - - - - - - -
- - - - - - - - - - - b - - b - - - - - - b - - - - - - -
- - - - - - - - - - b - - - b - - - - - - b - - - - - - -
- - - - - - - - - b - - - - b - - - - - - - 0 - - - - - -
- - - - - - - - - b - - - - b - - - - 0 0 0 0 0 0 0 - - -
- - - - - - - - b - - - - b - - - - 0 0 0 0 x 0 0 0 0 - -
- - - - - - - b - - - - - b - - - 0 0 0 0 0 x 0 0 0 0 0 -
- - - - - - - 0 - - - - - b - - 0 0 0 0 0 0 0 0 0 0 0 0 b
- - - 0 0 0 0 0 0 0 - - b - - - 0 0 0 0 0 0 0 0 0 0 0 0 0
- - 0 0 0 0 x 0 0 0 0 - 0 - - - 0 0 0 0 0 2 1 2 0 0 0 0 0
- 0 0 0 0 0 x 0 0 0 0 0 0 - - - 0 0 0 0 0 1 2 3 0 0 0 0 0
b 0 0 0 0 0 0 0 x x x 0 x 0 0 0 x 0 0 0 0 3 1 3 0 0 0 0 0
0 0 0 0 0 0 0 0 0 0 0 0 x 0 0 0 0 x 0 0 0 0 0 0 0 0 0 0 b
0 0 0 0 0 3 2 3 0 0 0 0 x 0 0 0 0 0 x 0 0 0 0 0 0 0 0 0 -
0 0 0 0 0 2 3 1 0 0 0 0 0 0 0 0 0 0 0 x 0 0 0 0 0 0 0 0 - 
0 0 0 0 0 1 2 1 0 0 0 0 0 0 0 0 0 0 0 x 0 0 0 0 0 0 0 - -
- 0 0 0 0 0 0 0 0 0 0 0 0 0 0 0 0 0 0 x 0 0 0 0 0 0 - - -
- b 0 0 0 x 0 0 0 0 0 1 3 1 0 0 0 0 0 0 - - - - - - - - -
- - 0 0 0 x 0 0 0 0 0 3 1 2 0 0 0 0 0 0 - - - - - - - - -
- - - 0 0 x 0 0 0 0 0 2 3 2 0 0 0 0 0 - - - - - - - - - -
- - - - - - 0 0 0 0 0 0 0 0 0 0 0 0 0 - - - - - - - - - -
- - - - - - - b 0 0 0 0 0 0 0 0 0 b - - - - - - - - - - -
- - - - - - - - 0 0 0 0 0 0 0 0 0 - - - - - - - - - - - -
- - - - - - - - - 0 0 0 0 0 0 0 - - - - - - - - - - - - -