4
0
6 2
42 42
-  -  -  -  -  0  0  0  -  -  -  0  0  0  -  -  -  -  -  -  -  -  -  -  -  -  -  -  0  0  0  -  -  -  0  0  0  -  -  -  -  -
-  -  -  -  1  0  0  0  1  -  1  0  0  1  0  -  -  -  -  -  -  -  -  -  -  -  -  0  0  0  0  3  -  0  0  0  0  0  -  -  -  -
-  -  -  -  0  1  1  1  0  -  0  1  1  1  1  -  -  -  -  -  -  -  -  -  -  -  -  0  0  0  3  0  -  0  0  3  0  0  -  -  -  -
-  -  -  -  0  1  1  1  0  -  1  1  1  1  1  -  -  -  -  -  -  -  -  -  -  -  -  3  3  3  0  0  -  0  0  3  3  0  -  -  -  -
-  2  1  -  1  1  1  1  0  -  1  1  1  1  1  -  0  0  -  -  -  -  -  -  0  0  -  0  3  3  0  0  -  0  0  3  3  3  -  0  0  -
1  1  1  -  1  0  0  0  0  -  1  1  0  1  1  -  0  0  3  -  -  -  -  0  0  0  -  3  0  3  0  0  -  0  0  0  0  0  -  0  1  0
1  1  1  1  -  0  0  0  0  -  0  0  0  0  -  1  3  3  3  -  -  -  -  0  0  0  3  -  0  0  0  0  -  0  0  0  0  -  1  1  0  0
1  1  1  1  -  0  0  0  0  -  0  0  0  0  -  3  3  3  3  -  -  -  -  3  3  3  0  -  0  0  0  0  -  0  0  0  0  -  1  1  1  1
1  1  1  1  0  -  1  0  -  -  -  0  0  -  3  3  3  3  3  -  -  -  -  0  3  3  0  0  -  0  0  -  -  -  0  0  -  0  1  1  1  1
1  1  1  0  0  -  -  -  -  -  -  -  -  -  3  3  3  3  3  -  -  -  -  3  0  3  3  0  -  -  -  -  -  -  -  -  -  0  0  1  0  1
-  0  0  0  -  -  1  1  1  1  1  1  1  -  -  3  3  3  -  -  -  -  -  -  0  0  0  -  -  0  0  0  0  0  0  0  -  -  0  1  0  -
-  -  0  -  -  1  1  1  1  1  1  1  0  3  -  -  3  -  -  -  -  -  -  -  -  0  -  -  0  0  0  0  0  0  0  0  0  -  -  0  -  -
-  -  -  -  1  1  1  1  1  1  1  1  0  3  3  -  -  -  -  -  -  -  -  -  -  -  -  0  0  0  0  0  4  0  0  0  0  0  -  -  -  -
-  -  -  1  1  0  1  1  1  1  1  0  0  3  3  3  -  -  -  -  -  -  -  -  -  -  0  0  0  0  0  4  4  4  4  0  0  0  0  -  -  -
-  -  -  0  0  0  1  1  1  0  0  0  0  3  0  0  -  -  -  -  -  -  -  -  -  -  0  0  0  0  4  4  4  0  0  0  0  0  0  -  -  -
-  -  -  0  0  1  0  1  1  1  0  0  0  3  0  0  -  -  -  -  -  -  -  -  -  -  0  0  0  0  0  0  4  0  0  0  0  0  0  -  -  -
-  -  -  0  0  0  0  0  0  0  0  0  0  3  0  0  -  -  -  -  -  -  -  -  -  -  0  0  0  0  0  0  0  0  0  0  0  0  0  -  -  -
-  -  -  -  0  0  0  0  0  -  0  0  0  0  3  -  -  -  -  -  -  -  -  -  -  -  -  3  0  0  0  0  -  0  0  0  0  0  -  -  -  -
-  -  -  -  -  0  0  0  -  -  -  0  0  0  -  -  -  -  -  -  -  -  -  -  -  -  -  -  0  0  0  -  -  -  0  0  0  -  -  -  -  -
-  -  -  -  -  -  -  -  -  -  -  -  -  -  -  -  -  -  -  3  4  1  3  -  -  -  -  -  -  -  -  -  -  -  -  -  -  -  -  -  -  -
-  -  -  -  -  -  -  -  -  -  -  -  -  -  -  -  -  -  -  2  3  3  1  -  -  -  -  -  -  -  -  -  -  -  -  -  -  -  -  -  -  -
-  -  -  -  -  -  -  -  -  -  -  -  -  -  -  -  -  -  -  1  3  3  4  -  -  -  -  -  -  -  -  -  -  -  -  -  -  -  -  -  -  -
-  -  -  -  -  -  -  -  -  -  -  -  -  -  -  -  -  -  -  3  3  3  3  -  -  -  -  -  -  -  -  -  -  -  -  -  -  -  -  -  -  -
-  -  -  -  -  0  0  0  -  -  -  0  0  3  -  -  -  -  -  -  -  -  -  -  -  -  -  -  3  3  0  -  -  -  0  0  0  -  -  -  -  -
-  -  -  -  0  0  3  0  0  -  0  0  0  3  3  -  -  -  -  -  -  -  -  -  -  -  -  0  0  3  0  0  -  0  0  0  0  0  -  -  -  -
-  -  -  -  0  0  3  0  0  -  0  0  3  0  3  -  -  -  -  -  -  -  -  -  -  -  -  0  0  3  0  0  -  0  0  4  0  0  -  -  -  -
-  -  -  -  0  3  3  0  0  -  3  3  3  3  3  -  -  -  -  -  -  -  -  -  -  -  -  0  3  3  0  0  -  0  0  4  4  0  -  -  -  -
-  0  1  -  3  3  3  3  0  -  0  0  3  3  0  -  0  0  -  -  -  -  -  -  0  0  -  3  3  3  0  0  -  0  2  2  2  2  -  0  0  -
0  0  1  -  0  0  0  0  0  -  0  0  3  0  0  -  0  0  3  -  -  -  -  0  0  0  -  0  0  0  0  0  -  0  0  4  4  0  -  0  0  2
0  0  1  0  -  0  0  0  0  -  0  0  0  0  -  0  0  0  3  -  -  -  -  0  0  0  3  -  0  0  0  0  -  0  0  4  2  -  0  4  0  2
0  1  1  0  -  0  0  0  0  -  0  0  0  0  -  0  3  3  3  -  -  -  -  0  3  3  0  -  0  0  0  0  -  0  0  0  0  -  2  2  4  2
0  1  1  4  1  -  0  0  -  -  -  0  0  -  0  0  3  3  3  -  -  -  -  3  3  3  0  0  -  0  0  -  -  -  0  0  -  0  0  4  4  2
1  0  0  0  4  -  -  -  -  -  -  -  -  -  0  3  0  0  3  -  -  -  -  0  0  0  0  0  -  -  -  -  -  -  -  -  -  0  0  4  0  2
-  0  0  0  -  -  2  0  4  0  2  2  0  -  -  0  0  0  -  -  -  -  -  -  0  0  0  -  -  0  4  0  2  0  0  0  -  -  0  0  0  -
-  -  0  -  -  4  2  4  4  4  2  2  4  4  -  -  0  -  -  -  -  -  -  -  -  0  -  -  0  0  0  2  0  0  0  0  0  -  -  0  -  -
-  -  -  -  2  4  4  2  4  2  4  2  0  0  0  -  -  -  -  -  -  -  -  -  -  -  -  0  0  4  2  4  4  4  4  4  4  4  -  -  -  -
-  -  -  0  0  4  4  4  2  4  4  4  4  0  0  0  -  -  -  -  -  -  -  -  -  -  0  0  0  2  0  2  2  2  2  4  4  2  0  -  -  -
-  -  -  4  4  4  4  2  4  2  4  4  4  0  0  0  -  -  -  -  -  -  -  -  -  -  0  0  0  0  4  4  2  4  4  4  4  0  0  -  -  -
-  -  -  0  0  4  2  4  2  4  4  4  4  0  0  0  -  -  -  -  -  -  -  -  -  -  0  0  0  0  0  4  0  2  0  0  0  0  0  -  -  -
-  -  -  2  0  2  4  4  4  2  4  0  4  0  0  0  -  -  -  -  -  -  -  -  -  -  0  0  0  0  4  0  0  0  2  0  0  0  0  -  -  -
-  -  -  -  2  0  2  0  0  -  2  0  0  0  0  -  -  -  -  -  -  -  -  -  -  -  -  0  0  0  0  0  -  0  0  2  0  0  -  -  -  -
-  -  -  -  -  2  0  0  -  -  -  2  0  0  -  -  -  -  -  -  -  -  -  -  -  -  -  -  0  0  0  -  -  -  0  0  0  -  -  -  -  -
2 11 3 <-> 3 13 0
3 10 3 <-> 4 12 0
4 9 3 <-> 5 11 0
6 8 4 <-> 6 10 0
7 8 4 <-> 7 10 0
11 8 4 <-> 11 10 0
12 8 4 <-> 12 10 0
14 9 5 <-> 13 11 0
14 12 0 <-> 15 10 5
15 13 0 <-> 16 11 5
14 17 3 <-> 19 19 7
27 17 5 <-> 22 19 1
25 11 3 <-> 26 13 0
26 10 3 <-> 27 12 0
27 9 3 <-> 28 11 0
29 8 4 <-> 29 10 0
30 8 4 <-> 30 10 0
34 8 4 <-> 34 10 0
35 8 4 <-> 35 10 0
37 9 5 <-> 36 11 0
38 10 5 <-> 37 12 0
39 11 5 <-> 38 13 0
4 16 5 <-> 1 28 7
5 17 5 <-> 5 24 7
9 16 4 <-> 9 33 0
2 34 3 <-> 3 36 0
4 35 0 <-> 3 33 3
5 34 0 <-> 4 32 3
6 33 0 <-> 6 31 4
7 31 4 <-> 7 33 0
11 31 4 <-> 11 33 0
12 33 0 <-> 12 31 4
14 32 5 <-> 13 34 0
15 33 5 <-> 14 35 0
16 34 5 <-> 15 36 0
13 24 1 <-> 13 17 3
17 28 1 <-> 14 16 3
13 23 1 <-> 19 22 6
23 28 7 <-> 18 28 1
25 34 3 <-> 26 36 0
27 35 0 <-> 26 33 3
28 34 0 <-> 27 32 3
18 32 3 <-> 23 32 5
29 31 4 <-> 29 33 0
30 33 0 <-> 30 31 4
34 31 4 <-> 34 33 0
35 31 4 <-> 35 33 0
37 32 5 <-> 36 34 0
38 33 5 <-> 37 35 0
39 34 5 <-> 38 36 0
24 28 7 <-> 27 16 5
28 17 5 <-> 28 24 7
32 16 4 <-> 32 33 0
36 17 3 <-> 36 24 1
37 16 3 <-> 40 28 1
28 23 7 <-> 22 22 2
18 5 1 <-> 23 5 7
18 9 3 <-> 23 9 5
