2
3
3 5
11 11
0 2 0 0 0 0 0 0 0 1 0
1 0 1 0 0 - 0 0 2 0 2
0 2 0 0 - 0 - 0 0 1 0
0 0 0 - 0 0 0 - 0 0 0
0 0 - 0 0 1 0 0 - 0 0
0 - 0 0 2 0 2 0 0 - 0
0 0 - 0 0 1 0 0 - 0 0
0 0 0 - 0 0 0 - 0 0 0
0 2 0 0 - 0 - 0 0 1 0
1 0 1 0 0 - 0 0 2 0 2
0 2 0 0 0 0 0 0 0 1 0