4 
0
0 2
9 9 
- - - b c b - - -
- 0 0 x x x 0 0 -
- 0 1 0 0 0 2 0 -
b x 0 1 x 2 0 x b
c x 0 x - x 0 x c
b x 0 4 x 3 0 x b
- 0 4 0 0 0 3 0 -
- 0 0 x x x 0 0 -
- - - b c b - - -
