4
255
255 0
40 40
3 3 3 3 3 3 3 3 3 3 3 3 3 3 3 3 3 3 3 3 3 3 3 3 3 3 3 3 3 3 3 3 3 3 3 3 3 3 3 3 
3 3 3 3 3 1 3 3 3 3 3 3 3 3 3 3 3 3 3 3 3 3 3 3 3 3 3 3 3 3 3 3 3 3 3 3 3 3 3 3 
3 3 3 3 3 3 3 3 3 3 3 3 3 3 3 3 3 3 3 3 3 3 3 3 3 3 3 3 3 3 3 3 3 3 3 3 3 3 3 3 
3 3 3 3 3 3 3 3 3 3 3 3 3 3 3 3 3 3 3 3 3 3 3 3 3 3 3 3 3 3 3 3 3 3 3 3 3 3 3 3 
3 3 3 3 3 3 3 1 3 3 3 3 3 3 3 3 3 3 3 3 3 3 3 3 3 3 3 3 3 3 3 3 3 3 3 3 3 3 3 3 
3 3 3 3 3 3 3 3 3 3 3 3 3 3 3 3 3 3 3 3 3 3 3 3 3 3 3 3 4 3 3 3 3 3 3 3 3 3 3 3 
3 3 3 3 3 3 3 3 3 3 3 3 3 3 3 3 3 3 3 3 3 3 3 3 3 3 3 4 3 3 3 3 4 3 3 3 3 3 3 3 
3 3 3 3 3 3 3 3 3 3 3 3 3 3 3 3 3 3 3 3 3 3 3 3 3 3 3 3 3 3 3 3 3 4 3 3 3 3 3 3 
3 3 3 3 3 3 3 3 3 3 3 3 3 3 3 3 3 3 3 3 3 3 3 3 3 3 3 3 3 3 3 3 3 3 3 3 3 3 3 3 
3 3 3 3 3 3 3 3 3 3 3 3 3 3 3 3 3 3 3 3 3 3 3 3 3 3 3 3 3 3 3 3 3 3 3 3 3 3 3 3 
3 3 3 3 3 - - - - - - - - - - 3 3 3 3 3 3 3 3 3 3 - - - - - - - - - - 3 3 3 3 3 
3 3 3 3 3 - - - - - - - - - - 3 3 3 3 3 3 3 3 3 3 - - - - - - - - - - 3 3 3 3 3 
3 3 3 3 3 - - - - - - - - - - 3 3 3 3 3 3 3 3 3 3 - - - - - - - - - - 3 3 3 3 3 
3 3 3 3 3 - - - - - - - - - - 3 3 3 3 4 3 3 3 3 3 - - - - - - - - - - 3 3 3 3 3 
0 3 3 3 3 - - - - - - - - - - 3 3 3 3 3 3 1 3 3 3 - - - - - - - - - - 3 3 3 0 0 
3 0 3 3 3 - - - - - - - - - - 3 3 3 3 3 3 3 3 3 3 - - - - - - - - - - 3 3 3 0 0 
0 0 0 0 3 - - - - - - - - - - 3 3 3 3 3 3 3 3 3 3 - - - - - - - - - - 3 3 3 0 0 
0 0 0 0 3 - - - - - - - - - - 3 3 3 3 3 3 3 3 3 3 - - - - - - - - - - 3 3 3 0 0 
0 0 0 0 3 - - - - - - - - - - 3 3 3 3 3 3 3 3 3 3 - - - - - - - - - - 3 3 3 0 0 
0 0 0 0 3 - - - - - - - - - - 3 3 3 3 3 3 3 3 3 3 - - - - - - - - - - 3 3 3 0 0 
0 0 0 0 0 0 0 0 0 0 0 0 0 0 3 - - - - - - - - - - 3 0 0 0 0 0 0 0 3 0 3 0 3 0 0 
0 0 0 0 0 0 0 0 0 0 0 0 0 3 0 - - - - - - - - - - 0 3 0 0 0 3 0 0 3 0 3 0 3 3 0 
0 0 0 0 0 0 0 0 0 0 0 0 3 0 0 - - - - - - - - - - 0 0 3 0 0 0 3 0 3 0 3 0 3 0 0 
0 0 0 0 0 0 0 0 0 0 0 3 0 0 0 - - - - - - - - - - 0 0 0 3 0 3 3 3 3 3 3 3 3 0 0 
0 0 0 0 0 0 0 0 0 0 3 0 0 0 0 - - - - - - - - - - 0 0 0 0 3 0 3 0 3 0 3 0 3 0 0 
0 0 0 0 0 0 0 0 0 3 - - - - - - - - - - - - - - - - - - - - 3 0 3 3 3 3 3 3 3 3 
0 0 0 0 0 0 0 0 3 0 - - - - - - - - - - - - - - - - - - - - 0 3 0 3 0 3 0 3 0 3 
0 0 0 0 0 0 0 3 0 0 - - - - - - - - - - - - - - - - - - - - 3 3 3 3 3 3 3 3 3 3 
0 0 0 0 0 0 3 0 0 0 - - - - - - - - - - - - - - - - - - - - 0 3 0 3 0 3 0 3 0 3 
0 0 0 0 0 3 0 0 0 0 - - - - - - - - - - - - - - - - - - - - 3 3 3 3 3 3 3 3 3 3 
0 0 0 0 3 0 0 0 0 0 - - - - - - - - - - - - - - - - - - - - 0 3 0 3 0 3 0 3 0 3 
0 0 0 3 0 0 0 0 0 0 - - - - - - - - - - - - - - - - - - - - 0 0 3 3 3 3 3 3 3 3 
0 0 3 0 0 0 0 0 0 0 - - - - - - - - - - - - - - - - - - - - 0 3 0 3 0 3 0 3 0 3 
0 3 0 0 0 0 0 0 0 0 - - - - - - - - - - - - - - - - - - - - 3 3 3 3 3 3 3 3 3 3 
3 0 0 0 0 0 0 0 0 0 - - - - - - - - - - - - - - - - - - - - 0 3 0 3 0 3 0 3 0 3 
0 0 0 0 0 0 0 0 0 0 - - - - - 3 3 3 3 3 3 3 3 3 3 - - - - - 3 0 3 3 0 3 3 3 0 0 
0 0 0 0 0 0 0 0 0 0 - - - - - 3 3 3 3 3 3 3 3 3 3 - - - - - 0 0 0 3 0 3 0 3 0 0 
0 0 0 0 0 0 0 0 0 0 - - - - - 3 3 4 3 4 3 3 3 3 3 - - - - - 0 0 0 3 3 3 0 3 0 0 
0 0 0 0 0 0 0 0 0 0 - - - - - 3 3 3 3 3 3 3 3 3 3 - - - - - 0 0 0 3 0 3 0 3 0 0 
b 0 0 0 0 0 0 0 0 0 - - - - - 3 3 2 2 3 3 3 3 3 3 - - - - - 0 0 0 3 0 3 0 3 0 b
15 19 4 <-> 15 35 0
16 19 4 <-> 16 35 0
17 19 4 <-> 17 35 0
18 19 4 <-> 18 35 0
19 19 4 <-> 19 35 0
20 19 4 <-> 20 35 0
21 19 4 <-> 21 35 0
22 19 4 <-> 22 35 0
23 19 4 <-> 23 35 0
24 19 4 <-> 24 35 0
15 0 0 <-> 15 39 4
16 0 0 <-> 16 39 4
17 0 0 <-> 17 39 4
18 0 0 <-> 18 39 4
19 0 0 <-> 19 39 4
20 0 0 <-> 20 39 4
21 0 0 <-> 21 39 4
22 0 0 <-> 22 39 4
23 0 0 <-> 23 39 4
24 0 0 <-> 24 39 4
