4
10
0 0
20 20
1 0 1 0 1 0 0 b - 2 2 - b 0 0 0 0 0 0 0
1 1 1 1 1 0 0 c - 2 2 - c 0 0 1 1 1 1 1
1 0 1 0 1 0 0 b 2 2 2 2 b 0 0 0 0 0 0 0
0 0 0 0 1 0 0 2 2 2 2 2 2 0 0 1 0 0 0 0
0 0 0 0 1 0 0 b - 2 2 - b 0 0 1 0 0 0 0
0 0 0 0 0 0 0 c - 2 2 - c 0 0 1 0 0 0 0
0 0 0 0 0 0 0 b - 2 2 - b 0 0 0 0 0 0 0
b c b c b c b c - 2 2 - c b c b c b c b
- - 3 x - - - - - 2 2 - - - - - x x - -
2 2 3 2 2 2 2 2 2 2 2 2 2 2 2 2 2 2 2 2
2 2 3 2 2 2 2 2 2 2 2 2 2 2 2 2 2 2 2 2
- - 3 x - - - - - 2 2 - - - - - x x - -
b c 3 c b c b c - 2 2 - c b c b c b c b
0 0 0 0 0 0 0 b - 2 2 - b 0 0 0 0 0 0 0
0 0 0 0 0 0 0 c - 2 2 - c 0 0 3 0 0 0 0
0 0 0 0 3 0 0 b - 2 2 - b 0 0 3 0 0 0 0
0 0 0 0 3 0 0 c x 2 2 x c 0 0 3 0 0 0 0
0 0 0 0 3 0 0 b x 2 2 x b 0 0 0 0 0 0 0
0 3 3 3 3 3 0 c - 2 2 - c 0 2 2 2 2 2 0
0 0 0 0 0 0 0 b - 2 2 - b 0 0 0 0 0 0 0
