4
3
0 8
25 25
c b x 0 - - - - 0 0 0 0 0 0 0 0 0 - - - - 0 x b c
b x x 0 - - - - - 0 0 0 0 0 0 0 - - - - - 0 x x b
x x 0 0 - - - - - - 0 0 0 0 0 - - - - - - 0 0 x x
0 0 0 0 0 - - - - - - 0 0 0 - - - - - - 0 0 0 0 0
- - 0 0 0 0 - - - - - 0 0 0 - - - - - 0 0 0 0 - -
- - - 0 0 0 0 0 0 0 0 0 0 0 0 0 0 0 0 0 0 0 - - -
- - - - 0 0 0 0 0 0 0 0 0 0 0 0 0 0 0 0 0 - - - -
- - - - - 0 0 0 0 - - - - - - - 0 0 0 0 - - - - -
0 0 0 0 - 0 0 0 - - - - - - - - - 0 0 0 - 0 0 0 0
x x x 0 - 0 0 - - - - 0 0 0 - - - - 0 0 - 0 x x x
x b x 0 - 0 0 - - - 0 0 x 0 0 - - - 0 0 - 0 x b x
x x x 0 - 0 0 - - 0 0 x b x 0 0 - - 0 0 - 0 x x x
0 0 0 0 - 0 0 - - 0 x b i b x 0 - - 0 0 - 0 0 0 0
- - - - - 0 0 - - 0 0 x b x 0 0 - - 0 0 - - - - -
- - - - - 0 0 - - - 0 0 x 0 0 - - - 0 0 - - - - -
- - - - 0 0 0 0 - - - 0 0 0 - - - 0 0 0 0 - - - -
- 0 0 0 0 0 0 0 0 0 - - - - - 0 0 0 0 0 0 0 0 0 -
- 0 0 0 0 1 2 0 0 0 0 0 0 0 0 0 0 0 3 4 0 0 0 0 -
- 0 0 0 0 2 1 0 0 0 0 0 0 0 0 0 0 0 4 3 0 0 0 0 -
- 0 0 0 0 0 0 0 0 0 0 0 0 0 0 0 0 0 0 0 0 0 0 0 -
- 0 0 0 - - - - - - 0 0 0 0 0 - - - - - - 0 0 0 -
- - 0 0 0 - - - - - 0 x x x 0 - - - - - 0 0 0 - -
- - - 0 0 0 0 - - - 0 x c x 0 - - - 0 0 0 0 - - -
- - - - 0 0 0 0 - - 0 x x x 0 - - 0 0 0 0 - - - -
- - - - 0 0 b 0 0 - - 0 0 0 - - 0 0 b 0 0 - - - -
4 24 4 <-> 3 8 2
5 24 4 <-> 3 9 2
6 24 4 <-> 3 10 2
7 24 4 <-> 3 11 2
8 24 4 <-> 3 12 2
16 24 4 <-> 21 8 6
17 24 4 <-> 21 9 6
18 24 4 <-> 21 10 6
19 24 4 <-> 21 11 6
20 24 4 <-> 21 12 6
11 9 0 <-> 0 8 0 
12 9 0 <-> 1 8 0 
13 9 0 <-> 2 8 0 
9 11 6 <-> 0 12 4 
9 12 6 <-> 1 12 4 
9 13 6 <-> 2 12 4
11 15 4 <-> 22 8 0 
12 15 4 <-> 23 8 0 
13 15 4 <-> 24 8 0 
15 11 2 <-> 22 12 4 
15 12 2 <-> 23 12 4 
15 13 2 <-> 24 12 4

