8
2
3 2
47 49
0 0 0 0 0 0 0 0 0 0 0 0 - 1 1 1 1 1 1 1 1 1 1 1 1 1 1 1 1 1 1 1 1 1 1 1 1 1 1 1 1 1 1 1 1 1 1 1 1
0 0 0 0 0 0 0 0 0 0 0 0 - 1 1 1 1 1 1 1 1 1 8 1 1 1 8 8 1 1 1 8 8 1 8 8 8 8 1 8 8 8 8 1 1 1 1 1 1
0 0 0 0 0 0 0 0 0 0 0 0 - 1 1 1 1 1 1 8 1 1 1 1 1 8 8 1 1 1 7 8 7 8 1 7 7 7 1 7 8 8 8 1 7 1 7 1 1
0 0 0 0 0 0 0 0 0 0 0 0 - 1 1 8 1 1 1 1 8 1 1 1 8 8 1 1 1 7 8 7 7 8 8 1 7 7 1 7 7 8 8 8 1 1 1 1 1
0 0 0 0 0 0 0 0 0 0 0 0 - 1 1 1 8 1 1 1 1 8 1 8 1 8 1 1 7 8 7 7 7 8 7 1 1 7 1 7 7 1 8 1 1 1 7 1 1
0 0 0 0 0 0 0 0 0 0 0 0 - 1 1 8 1 1 1 1 8 1 1 8 1 1 1 7 1 8 7 7 7 8 8 1 8 1 7 5 1 8 1 1 1 6 7 1 1
0 0 0 0 0 0 0 0 0 0 0 0 - 1 1 1 8 1 1 1 1 1 8 1 1 1 1 1 7 8 1 7 1 8 8 1 7 7 1 5 8 1 8 1 1 6 8 1 1
0 0 0 0 0 0 0 0 0 0 0 0 - 1 1 1 8 1 8 1 1 1 1 1 1 1 8 1 1 8 1 1 5 8 8 1 7 1 5 8 1 7 8 6 1 6 8 1 1
0 0 0 0 0 0 0 0 0 0 0 0 - 1 1 8 1 8 8 8 1 1 1 1 7 1 1 7 1 8 8 5 1 8 8 1 5 5 1 1 7 1 8 7 1 6 1 1 1
0 0 0 0 0 0 0 0 0 0 0 0 - 1 1 1 8 8 8 1 8 1 1 1 1 7 8 1 7 1 5 8 1 1 7 1 5 1 1 7 7 6 8 7 1 6 1 1 1
0 0 0 0 0 0 0 0 0 0 0 0 - 1 1 8 1 8 1 1 1 8 7 1 1 1 8 1 1 8 1 1 8 7 1 1 5 1 5 5 7 6 8 7 1 6 1 8 1
0 0 0 0 0 0 0 0 0 0 0 0 - 1 8 1 1 1 1 1 1 1 8 7 1 1 7 1 5 1 8 1 7 7 5 1 1 7 5 6 7 6 8 7 1 1 1 8 1
0 0 0 0 0 0 0 0 0 0 0 0 - 1 8 1 1 8 1 1 1 1 7 8 1 1 1 1 7 1 1 7 1 7 8 1 1 5 5 6 7 5 8 8 1 6 8 8 1
0 0 0 0 0 0 0 0 0 0 0 0 - 1 8 1 1 1 8 1 1 7 1 7 7 7 1 1 1 1 7 1 1 7 1 1 1 7 6 6 7 6 8 7 1 8 1 8 1
0 0 0 0 0 0 0 0 0 0 0 0 - 1 8 8 1 1 8 1 7 8 1 1 7 7 6 1 7 1 1 5 1 1 1 1 1 6 6 7 7 5 8 7 1 1 1 8 1
0 0 0 0 0 0 0 0 0 0 0 0 - 1 8 1 8 1 1 1 1 8 7 1 1 7 8 1 1 1 5 5 1 7 1 1 1 6 7 8 5 7 8 6 1 8 1 8 1
0 0 0 0 0 0 0 0 0 0 0 0 - 1 8 1 1 1 7 1 7 8 7 1 1 7 7 1 6 1 7 1 8 7 1 1 1 7 6 8 7 6 8 1 1 7 7 8 1
0 0 0 0 0 0 0 0 0 0 0 0 - 1 8 8 1 7 8 1 7 8 7 1 1 7 7 7 8 1 1 5 5 8 1 1 7 1 6 8 7 8 8 6 7 7 7 8 1
0 0 0 0 0 0 0 0 0 0 0 0 - 1 8 1 8 8 8 1 7 5 7 1 1 1 6 1 7 1 6 5 5 7 1 7 1 5 6 8 8 1 8 6 7 7 7 8 1
0 0 0 0 0 0 0 0 0 0 0 0 - 1 8 1 1 8 8 1 7 8 7 8 1 6 1 1 1 7 8 5 5 5 7 8 5 5 6 8 7 6 8 8 7 7 7 8 1
0 0 0 0 0 0 0 0 0 0 0 0 - 1 1 1 1 8 8 5 7 5 7 1 6 7 7 1 1 1 7 8 5 5 5 5 7 5 6 8 7 6 6 8 7 7 7 8 1
0 0 0 0 0 0 0 0 0 0 0 0 - 1 1 1 1 8 8 5 7 5 7 6 1 7 1 1 1 1 8 7 7 7 5 7 6 5 6 8 7 1 8 6 7 7 7 8 1
0 0 0 0 0 0 0 0 0 0 0 0 - 1 1 1 1 1 8 5 7 5 6 6 6 1 6 1 1 1 5 7 7 5 7 5 8 5 6 8 7 1 6 1 7 7 7 8 1
0 0 0 0 0 0 0 0 0 0 0 0 - 1 8 1 1 1 8 5 5 6 7 6 1 6 8 1 1 5 7 5 5 7 5 8 5 5 6 8 7 1 6 1 7 7 7 1 1
0 0 0 0 0 0 0 0 0 0 0 0 - 1 8 1 8 1 1 5 7 5 7 1 5 6 6 1 5 7 8 5 5 7 7 5 8 5 6 8 5 7 6 1 7 7 7 8 1
0 0 0 0 0 0 0 0 0 0 0 0 - 1 5 1 8 8 8 1 7 7 1 6 8 5 6 5 7 1 8 5 7 7 8 7 5 5 5 8 6 5 7 7 7 7 7 8 1
0 0 0 0 0 0 0 0 0 0 0 0 - 1 8 5 8 8 8 1 1 1 7 5 5 1 5 7 6 5 5 5 5 7 6 6 7 5 6 5 6 6 7 7 7 7 7 1 1
0 0 0 0 0 0 0 0 0 0 0 0 - 1 1 1 5 8 8 7 1 1 6 5 5 1 7 1 6 5 7 5 5 6 6 7 7 7 5 8 5 8 7 5 7 7 7 1 1
0 0 0 0 0 0 0 0 0 0 0 0 - 1 1 1 5 5 8 1 1 6 5 1 5 5 1 6 5 7 8 5 6 6 6 6 1 5 7 5 6 5 8 7 7 7 7 8 1
0 0 0 0 0 0 6 0 0 0 0 0 - 1 1 1 5 5 1 8 1 6 1 5 7 1 5 1 7 7 1 5 6 5 7 6 6 1 5 7 6 5 5 8 7 7 7 1 1
0 0 0 0 0 0 0 6 0 0 0 0 - 1 1 1 5 1 5 7 1 1 6 7 1 1 6 5 1 1 7 6 5 7 7 5 6 6 7 1 6 5 5 8 8 7 7 1 1
0 0 0 0 0 0 0 0 6 0 0 0 - 1 5 8 1 1 6 5 1 8 1 6 6 1 7 7 5 1 6 7 1 5 7 7 5 6 7 8 6 7 5 1 8 8 1 5 6
0 0 0 0 0 0 0 0 0 6 0 0 - 1 8 1 5 1 1 6 5 7 5 1 6 6 6 1 8 6 1 5 1 1 5 1 7 1 7 8 7 1 7 1 7 8 8 6 6
0 0 0 0 0 0 0 0 0 0 6 0 - 1 1 1 1 5 5 1 1 5 5 5 1 1 6 6 6 8 5 1 1 1 1 1 1 7 7 7 6 6 1 1 1 7 8 8 6
0 0 0 0 0 0 0 0 0 0 0 6 - 1 1 1 1 1 1 1 1 1 1 1 1 1 1 1 1 1 1 1 1 1 1 1 5 8 8 8 8 8 8 8 8 8 8 8 8
- - - - - - - - - - - - - - - - - - - - - - - - - - - - - - - - - - - - - - - - - - - - - - - - -
0 0 0 0 0 0 0 0 0 0 0 1 - 6 6 6 6 6 6 6 6 6 6 6 6 6 6 6 6 6 6 6 6 6 6 6 6 6 5 5 5 5 6 6 6 6 6 6 6
0 0 0 0 0 0 0 0 0 0 1 0 - 6 6 6 6 6 6 6 6 6 6 6 6 6 6 6 6 6 6 6 6 6 6 6 6 6 5 5 5 6 6 5 5 6 6 5 6
0 0 0 0 0 0 0 0 0 1 0 0 - 6 6 6 6 6 6 6 6 6 6 6 6 6 6 6 6 6 6 6 6 6 6 6 6 6 5 5 5 6 6 5 6 6 5 5 6
0 0 0 0 0 0 0 0 1 0 0 0 - 6 5 6 6 6 6 6 6 6 6 6 6 6 6 6 6 6 6 6 6 6 6 6 6 6 5 5 5 6 5 6 6 5 6 5 6
0 0 0 0 0 0 0 1 0 0 0 0 - 6 5 6 6 6 6 5 6 5 5 5 6 6 6 5 5 5 5 5 5 6 6 6 5 6 6 5 5 5 5 6 5 5 5 6 6
0 0 0 0 0 0 1 0 0 0 0 0 - 6 5 5 6 6 6 6 5 5 6 6 5 6 6 5 5 5 6 5 6 5 6 6 6 5 5 5 5 6 6 5 5 6 6 6 6
0 0 0 0 0 1 0 0 0 0 0 0 - 6 5 6 6 5 6 6 6 5 5 6 6 5 5 6 5 5 5 6 5 6 6 6 6 5 5 5 5 5 5 6 5 6 6 6 6
0 0 0 0 1 0 0 0 0 0 0 0 - 6 5 5 6 6 5 6 6 5 5 5 6 5 5 5 6 5 5 5 5 6 6 6 5 5 6 6 5 5 6 6 5 6 6 6 6
0 0 0 0 0 0 0 0 0 0 0 0 - 6 6 5 6 6 6 5 5 6 5 6 5 6 5 6 5 6 5 5 6 6 5 5 6 6 5 5 6 6 5 6 5 6 6 5 6
0 0 0 0 0 0 0 0 0 0 0 0 - 6 5 6 5 5 5 6 6 6 6 6 6 6 6 6 6 6 6 6 5 5 5 6 6 6 6 5 5 6 6 6 6 6 6 6 6
0 0 0 0 0 0 0 0 0 0 0 0 - 5 5 5 5 5 5 6 6 6 6 6 6 6 6 6 6 6 6 6 5 5 5 6 6 6 6 6 6 6 6 6 6 6 6 6 6
11   34   3   <->   13   36   7
13   34   5   <->   11   36   1

