2
0
0 0
20 20
- - - - - - - - - - - - - - - - - - - -
- b b - - - - - - - - - - - - - - c c -
- b 0 - - - - - - - - - - - - - - 0 c -
- - - - - - - - - - - - - - - - - - - -
- - - - - - - - - - - - - - - - - - - -
- - - - - 1 1 1 0 0 0 0 2 2 2 - - - - -
- - - - - 1 1 0 0 0 0 0 0 2 2 - - - - -
- - - - - 1 0 0 0 0 0 0 0 0 2 - - - - -
- - - - - 0 0 0 0 0 0 0 0 0 0 - - - - -
- - - - - 0 0 0 2 2 2 0 0 0 0 - - - - -
- - - - - 0 0 0 0 2 2 0 0 0 0 - - - - -
- - - - - 0 0 0 0 0 2 0 0 0 0 - - - - -
- - - - - 0 1 0 0 0 0 0 0 0 1 - - - - -
- - - - - 1 1 0 0 0 0 0 0 1 1 - - - - -
- - - - - 2 1 0 0 0 0 0 0 2 1 - - - - -
- - - - - - - - - - - - - - - - - - - -
- - - - - - - - - - - - - - - - - - - -
- i 0 - - - - - - - - - - - - - - 0 x -
- i i - - - - - - - - - - - - - - x x -
- - - - - - - - - - - - - - - - - - - -