2
10
0 0
5 5
0 x 0 x 0
x 0 x 0 x
0 x 0 x 0
0 0 0 0 0
2 0 x 0 1